 0 0 0 0 0 0 0 0 0 0 0 0 0 0 0 0 0 0 0 0 0 0 0 0 0 0 0 0 0 0 0 0 0 0 0 0 0 0 0 0 0 0 0 0 0 0 0 0 0 0 0 0 0 0 0 0 0 0 0 0 0 0 0 0 0 0 0 0 0 0 0 0 0 0 0 0 0 0 0 0 0 0 0 0 0 0 0 0 0 0 0 0 0 0 0 0 0 0 0 0 0 0 0 0 0 0 0 0 0 0 0 0 0 0 0 0 0 0 0 0 0 0 0 0 0 0 0 0 0 0 0 0 0 0 0 0 0 0 0 0 0 0 0 0 0 0 0 0 0 0 0 0 0 0 0 0 0 0 0 
 0 0 0 0 0 0 0 0 0 0 0 0 0 0 0 0 0 0 0 0 0 0 0 0 0 0 0 0 0 0 0 0 0 0 0 0 0 0 0 0 0 0 0 0 0 0 0 0 0 0 0 0 0 0 0 0 0 0 0 0 0 0 0 0 0 0 0 0 0 0 0 0 0 0 0 0 0 0 0 0 0 0 0 0 0 0 0 0 0 0 0 0 0 0 0 0 0 0 0 0 0 0 0 0 0 0 0 0 0 0 0 0 0 0 0 0 0 0 0 0 0 0 0 0 0 0 0 0 0 0 0 0 0 0 0 0 0 0 0 0 0 0 0 0 0 0 0 0 0 0 0 0 0 0 0 0 0 0 0 
 0 0 0 0 0 0 0 0 0 0 0 0 0 0 0 0 0 0 0 0 0 0 0 0 0 0 0 0 0 0 0 0 0 0 0 0 0 0 0 0 0 0 0 0 0 0 0 0 0 0 0 0 0 0 0 0 0 0 0 0 0 0 0 0 0 0 0 0 0 0 0 0 0 0 0 0 0 0 0 0 0 0 0 0 0 0 0 0 0 0 0 0 0 0 0 0 0 0 0 0 0 0 0 0 0 0 0 0 0 0 0 0 0 0 0 0 0 0 0 0 0 0 0 0 0 0 0 0 0 0 0 0 0 0 0 0 0 0 0 0 0 0 0 0 0 0 0 0 0 0 0 0 0 0 0 0 0 0 0 
 0 0 0 0 0 0 0 0 0 0 0 0 0 0 0 0 0 0 0 0 0 0 0 0 0 0 0 0 0 0 0 0 0 0 0 0 0 0 0 0 0 0 0 0 0 0 0 0 0 0 0 0 0 0 0 0 0 0 0 0 0 0 0 0 0 0 0 0 0 0 0 0 0 0 0 0 0 0 0 0 0 0 0 0 0 0 0 0 0 0 0 0 0 0 0 0 0 0 0 0 0 0 0 0 0 0 0 0 0 0 0 0 0 0 0 0 0 0 0 0 0 0 0 0 0 0 0 0 0 0 0 0 0 0 0 0 0 0 0 0 0 0 0 0 0 0 0 0 0 0 0 0 0 0 0 0 0 0 0 
 0 0 0 0 0 0 0 0 0 0 0 0 0 0 0 0 0 0 0 0 0 0 0 0 0 0 0 0 0 0 0 0 0 0 0 0 0 0 0 0 0 0 0 0 0 0 0 0 0 0 0 0 0 0 0 0 0 0 0 0 0 0 0 0 0 0 0 0 0 0 0 0 0 0 0 0 0 0 0 0 0 0 0 0 0 0 0 0 0 0 0 0 0 0 0 0 0 0 0 0 0 0 0 0 0 0 0 0 0 0 0 0 0 0 0 0 0 0 0 0 0 0 0 0 0 0 0 0 0 0 0 0 0 0 0 0 0 0 0 0 0 0 0 0 0 0 0 0 0 0 0 0 0 0 0 0 0 0 0 
 0 0 0 0 0 0 0 0 0 0 0 0 0 0 0 0 0 0 0 0 0 0 0 0 0 0 0 0 0 0 0 0 0 0 0 0 0 0 0 0 0 0 0 0 0 0 0 0 0 0 0 0 0 0 0 0 0 0 0 0 0 0 0 0 0 0 0 0 0 0 0 0 0 0 0 0 0 0 0 0 0 0 0 0 0 0 0 0 0 0 0 0 0 0 0 0 0 0 0 0 0 0 0 0 0 0 0 0 0 0 0 0 0 0 0 0 0 0 0 0 0 0 0 0 0 0 0 0 0 0 0 0 0 0 0 0 0 0 0 0 0 0 0 0 0 0 0 0 0 0 0 0 0 0 0 0 0 0 0 
 0 0 0 0 0 0 0 0 0 0 0 0 0 0 0 0 0 0 0 0 0 0 0 0 0 0 0 0 0 0 0 0 0 0 0 0 0 0 0 0 0 0 0 0 0 0 0 0 0 0 0 0 0 0 0 0 0 0 0 0 0 0 0 0 0 0 0 0 0 0 0 0 0 0 0 0 0 0 0 0 0 0 0 0 0 0 0 0 0 0 0 0 0 0 0 0 0 0 0 0 0 0 0 0 0 0 0 0 0 0 0 0 0 0 0 0 0 0 0 0 0 0 0 0 0 0 0 0 0 0 0 0 0 1 0 0 0 0 0 0 0 0 0 0 0 0 0 0 0 0 0 0 0 0 0 0 0 0 0 
 0 0 0 0 0 0 0 0 0 0 0 0 0 0 0 0 0 0 0 0 0 0 0 0 0 0 0 0 0 0 0 0 0 0 0 0 0 0 0 0 0 0 0 0 0 0 0 0 0 0 0 0 0 0 0 0 0 0 0 0 0 0 0 0 0 0 0 0 0 0 0 0 0 0 0 0 0 0 0 0 0 0 0 0 0 0 0 0 0 0 0 0 0 0 0 0 0 0 0 0 0 0 0 0 0 0 0 0 0 0 0 0 0 0 0 0 0 0 0 0 0 0 0 0 0 0 0 0 0 0 0 0 0 2 0 0 0 0 0 0 0 0 0 0 0 0 0 0 0 0 0 0 0 0 0 0 0 0 0 
 0 0 0 0 0 0 0 0 0 0 0 0 0 0 0 0 0 0 0 0 0 0 0 0 0 0 0 0 0 0 0 0 0 0 0 0 0 0 0 0 0 0 0 0 0 0 0 0 0 0 0 0 0 0 0 0 0 0 0 0 0 0 0 0 0 0 0 0 0 0 0 1 0 0 0 0 0 0 0 0 0 0 0 0 0 0 0 0 0 0 0 0 0 0 0 0 0 0 0 0 0 0 0 0 0 0 0 0 0 0 0 0 0 0 0 0 0 0 0 0 0 0 0 0 0 0 0 0 0 0 0 0 0 2 0 0 0 0 0 0 0 0 0 0 0 0 0 0 0 0 0 0 0 0 0 0 0 0 0 
 0 0 0 0 0 0 0 0 0 0 0 0 0 0 0 0 0 0 0 0 0 1 0 0 0 0 0 0 0 0 0 0 0 0 0 0 0 0 0 0 0 0 0 0 0 0 0 0 0 0 0 0 0 0 0 0 0 0 0 0 0 0 0 0 0 0 0 0 0 0 0 2 0 0 0 0 0 0 0 0 0 0 0 0 0 0 0 0 0 0 0 0 0 0 0 0 0 0 0 0 0 0 0 0 0 0 0 0 0 0 0 0 0 0 0 0 0 0 0 0 0 0 0 0 0 0 0 0 0 0 0 0 0 2 0 0 0 0 0 0 0 0 0 0 0 0 0 0 0 0 0 0 0 0 0 0 0 0 0 
 0 0 0 0 0 0 0 0 0 0 0 0 0 0 0 0 0 0 0 0 0 2 0 0 0 0 0 0 0 0 0 0 0 0 0 0 0 0 0 0 0 0 0 0 0 0 0 0 0 0 0 0 0 0 0 0 0 0 0 0 0 0 0 0 0 0 0 0 0 0 0 2 0 0 0 0 0 0 0 0 0 0 0 0 0 0 0 0 0 0 0 0 0 0 0 0 0 0 0 0 0 0 0 0 0 0 0 0 0 0 0 0 0 0 0 0 0 0 0 0 0 0 0 0 0 0 0 0 0 0 0 0 0 2 3 4 0 0 0 0 0 0 0 0 0 0 0 0 0 0 0 0 0 0 0 0 0 0 0 
 0 0 0 0 0 0 0 0 0 0 0 0 0 0 0 0 0 0 0 5 6 2 0 0 0 0 0 0 0 0 0 0 0 0 0 0 0 0 0 7 8 0 0 0 0 0 0 0 0 0 0 0 0 0 0 0 0 0 0 0 0 0 0 0 0 0 0 0 0 0 0 2 9 10 0 0 0 0 0 0 0 0 0 0 0 0 0 0 0 0 0 0 0 0 0 0 0 0 0 0 0 0 0 0 0 0 0 0 0 0 0 0 0 0 0 0 0 0 0 0 0 0 0 0 0 0 0 0 0 0 0 0 0 2 11 12 0 0 0 0 0 0 0 0 0 0 0 0 0 0 0 0 0 0 0 0 0 0 0 
 0 0 0 0 0 0 0 0 0 0 0 0 0 0 0 0 0 0 0 13 14 2 0 0 0 0 0 0 0 0 0 0 0 0 0 0 0 0 0 15 16 0 0 0 0 0 1 0 0 0 0 0 0 0 0 0 0 0 0 0 0 0 0 0 0 0 0 0 0 0 0 2 17 18 0 0 0 0 0 0 0 0 0 0 0 0 0 0 0 0 0 0 0 0 0 0 0 0 0 0 0 0 0 0 0 0 0 0 0 0 0 0 0 0 0 0 0 0 0 0 0 0 0 0 0 0 0 0 0 0 0 0 19 20 21 21 22 23 0 0 0 0 0 0 0 0 0 0 0 0 0 0 0 0 0 0 0 0 0 
 0 0 0 0 0 0 0 0 0 0 0 0 0 0 0 0 0 24 25 26 26 27 28 0 0 0 0 0 0 0 0 0 0 0 0 0 0 29 30 31 31 32 33 0 0 0 2 0 0 0 0 0 0 0 0 0 0 0 0 0 0 0 0 0 0 0 0 0 0 0 24 25 26 26 27 28 0 0 0 0 0 0 0 0 0 0 0 0 0 0 0 0 0 0 0 0 0 0 0 0 0 0 0 0 0 0 0 0 0 0 0 0 0 0 0 0 0 0 0 0 0 0 0 0 0 0 0 0 0 0 0 34 35 36 37 37 36 38 39 0 0 0 0 0 0 0 0 0 0 0 0 0 0 0 0 0 0 0 0 
 0 0 0 0 0 0 0 0 0 0 0 0 0 0 0 0 34 35 37 37 37 37 38 39 0 0 0 0 0 0 0 0 0 0 0 0 40 41 42 42 42 42 43 44 0 0 2 0 0 0 0 0 0 0 0 0 0 0 0 0 0 0 0 0 0 0 0 0 0 45 46 47 48 48 47 49 50 0 0 0 0 0 0 0 0 0 0 0 0 0 0 0 0 0 0 0 0 0 0 0 0 0 0 0 0 0 0 0 0 0 0 0 0 0 0 0 0 0 0 0 0 0 0 0 0 0 0 0 0 0 34 51 52 53 54 54 55 56 57 39 0 0 0 0 0 0 0 0 0 0 0 0 0 0 0 0 0 0 0 
 0 0 0 0 0 0 0 0 0 0 0 0 0 0 0 34 51 58 53 59 59 55 60 57 39 0 0 0 0 0 0 0 0 0 0 40 61 62 63 64 64 65 66 67 44 0 2 0 0 0 0 0 0 0 0 0 0 0 0 0 0 0 0 0 0 0 0 0 45 68 69 70 71 71 72 73 74 50 0 0 0 0 0 0 0 0 0 0 0 0 0 0 0 0 0 0 0 0 0 0 0 0 0 0 0 0 0 0 0 0 0 0 0 0 0 0 0 0 0 0 0 0 0 0 0 0 0 0 0 34 51 52 75 14 76 77 13 78 56 57 39 0 0 0 0 0 0 0 0 0 0 0 0 0 0 0 0 0 0 
 0 0 0 0 0 0 0 0 0 0 0 0 0 0 34 51 58 75 79 80 81 82 78 60 57 39 0 0 0 0 0 0 0 0 40 61 62 83 84 85 86 87 88 66 67 44 2 0 0 0 0 0 0 0 0 0 0 0 0 0 0 0 0 0 0 0 0 45 68 69 89 18 85 86 17 89 73 74 50 0 0 0 0 0 0 0 0 0 0 0 0 0 0 0 0 0 0 0 0 0 0 0 0 0 0 0 0 0 0 0 0 0 0 0 0 0 0 0 0 0 0 0 0 0 0 0 0 19 20 90 37 78 78 14 91 92 13 78 78 37 93 22 23 0 0 0 0 0 0 0 0 0 0 0 0 0 0 0 0 
 0 0 0 0 0 0 0 0 0 0 0 0 24 25 94 95 78 78 79 96 97 82 78 78 95 98 27 28 0 0 0 0 29 30 99 100 88 88 84 101 102 87 88 88 100 103 32 33 0 0 0 0 0 0 0 0 0 0 0 0 0 0 0 0 0 24 25 104 48 89 89 18 101 102 17 105 89 48 106 27 28 0 0 0 0 0 0 0 107 108 0 0 0 0 0 0 0 0 0 0 0 0 0 0 0 0 0 0 0 0 0 0 0 0 0 0 0 0 0 0 0 0 0 0 0 0 0 0 109 95 75 78 78 110 111 111 112 113 78 78 95 114 0 0 0 0 0 0 0 0 0 0 0 0 0 0 0 0 0 
 0 0 0 0 0 0 0 0 0 0 0 0 0 109 95 75 78 78 110 115 115 112 113 116 78 95 117 0 0 0 0 0 0 118 100 83 88 88 119 120 120 121 122 88 88 100 123 0 0 0 0 0 0 0 0 0 0 0 0 0 0 0 0 0 0 0 124 48 89 89 105 125 126 126 127 89 89 89 48 128 0 0 0 0 0 0 0 0 129 130 0 0 0 0 0 0 0 0 0 0 0 0 0 0 0 0 0 0 0 0 0 0 0 0 0 0 0 0 0 0 0 0 0 0 0 0 0 0 131 53 54 54 55 53 54 54 55 53 54 54 55 14 0 0 0 0 0 0 0 0 0 0 0 0 0 0 0 0 0 
 0 0 0 0 0 0 0 0 0 0 0 0 0 82 53 59 59 55 53 59 59 55 53 59 59 55 79 0 0 0 0 0 0 87 63 64 64 65 63 64 64 65 63 64 64 65 84 0 0 0 0 0 0 0 0 0 0 0 0 0 0 0 0 0 0 0 17 70 71 71 72 70 71 71 72 70 71 71 72 18 0 0 0 0 0 0 24 25 26 26 27 28 0 0 0 0 0 0 0 0 0 0 0 0 0 0 0 0 0 0 0 0 0 0 0 0 0 0 0 0 0 0 0 0 0 0 0 0 131 14 76 77 13 14 76 77 13 14 76 77 13 14 0 0 0 0 0 0 0 0 0 0 0 0 0 0 0 0 0 
 0 0 0 0 0 0 0 0 0 0 0 0 0 82 79 80 81 82 79 80 81 82 79 80 81 82 79 0 0 0 0 0 0 87 84 85 86 87 84 85 86 87 84 85 86 87 84 0 0 0 0 0 0 0 0 0 0 0 0 0 0 0 0 0 0 0 17 18 85 86 17 18 85 86 17 18 85 86 17 18 0 0 0 0 0 132 133 134 135 135 134 136 137 0 0 0 0 0 0 0 0 0 0 0 0 0 0 0 0 0 0 0 0 0 0 0 0 0 0 0 0 0 0 0 0 0 0 0 138 14 76 77 13 14 76 77 13 14 76 77 13 139 0 0 0 0 0 0 0 0 0 0 0 0 0 0 0 0 0 
 0 0 0 0 0 0 0 0 0 0 0 0 0 138 79 80 81 82 79 80 81 82 79 80 81 82 139 0 0 0 0 0 0 140 141 85 86 140 141 85 86 140 141 85 86 140 141 0 0 0 0 0 0 0 0 0 0 0 0 0 0 0 0 0 0 0 142 18 85 86 17 18 85 86 17 18 85 86 17 143 0 0 0 0 132 144 145 146 147 147 148 149 150 137 0 0 0 0 0 0 0 0 0 0 0 0 0 0 0 0 0 0 0 0 0 0 0 0 0 0 0 0 0 0 0 0 0 0 131 14 91 92 13 14 91 92 13 14 91 92 13 14 0 0 0 0 0 0 0 0 0 0 0 0 0 0 0 0 0 
 0 0 0 0 0 0 0 0 0 151 152 0 0 82 79 96 97 82 79 96 97 82 79 96 97 82 79 0 0 0 0 0 0 87 84 101 102 87 84 101 102 87 84 101 102 87 153 32 33 0 0 0 0 0 154 155 0 0 0 0 0 0 0 0 0 0 17 18 101 102 17 18 101 102 17 18 101 102 17 18 0 0 0 132 144 145 156 130 157 158 129 156 149 150 137 0 0 0 0 0 0 154 155 0 0 0 0 0 0 0 0 154 155 0 0 0 0 0 0 154 155 0 0 0 0 0 0 0 138 14 91 92 13 14 91 92 13 14 91 92 13 139 0 0 0 0 0 0 0 0 0 154 155 0 0 0 0 0 0 
 0 0 0 0 0 0 0 0 0 159 160 0 0 82 110 115 115 112 110 115 115 112 110 115 115 112 79 0 0 0 0 0 0 87 119 120 120 121 119 120 120 121 119 120 120 121 100 42 43 44 0 0 0 0 161 162 0 0 151 152 0 0 0 0 0 0 17 125 126 126 127 125 126 126 127 125 126 126 127 18 0 24 25 163 135 156 156 130 164 165 129 156 156 135 166 27 28 0 0 0 0 161 162 0 0 151 152 0 0 0 0 161 162 0 0 0 0 0 0 161 162 0 0 151 152 0 0 0 138 110 111 111 112 110 111 111 112 110 111 111 112 139 0 0 0 0 0 0 0 0 0 161 162 0 0 151 152 0 0 
 0 0 0 0 0 0 0 0 0 167 168 0 0 138 78 113 78 78 78 78 78 78 113 78 78 78 139 0 0 169 0 0 0 87 88 122 88 88 88 88 88 88 122 88 88 88 88 88 100 103 32 33 0 0 170 171 0 0 159 160 0 0 0 0 0 0 142 89 89 89 89 89 89 89 89 89 172 89 89 143 0 0 173 135 174 156 156 175 176 176 177 156 156 156 135 178 0 0 0 0 0 170 171 0 0 159 160 0 0 0 0 170 171 0 0 0 0 0 0 170 171 0 0 159 160 0 0 0 138 78 113 78 78 78 78 78 78 113 78 78 78 139 0 0 169 0 0 0 0 0 0 170 171 0 0 159 160 0 0 
 0 0 0 0 0 0 0 179 152 159 180 0 0 11 53 59 59 55 78 78 113 78 53 59 59 55 139 0 0 181 0 0 0 87 63 64 64 65 88 88 122 88 63 64 64 65 63 64 64 182 183 0 184 155 161 185 186 0 167 168 151 187 0 0 0 0 142 70 71 71 72 89 89 188 89 70 71 71 72 143 0 0 129 146 147 147 148 156 156 189 174 146 147 147 148 130 0 0 0 184 155 161 185 186 0 167 168 151 187 184 155 161 185 0 0 0 0 184 155 161 185 186 0 167 168 151 187 0 131 53 54 54 55 78 78 113 78 53 54 54 55 14 0 0 181 0 0 0 0 184 155 161 185 186 0 167 168 151 187 
 0 0 0 0 0 0 0 0 190 191 192 193 0 82 79 80 81 82 53 59 59 55 79 80 81 82 79 0 0 181 0 0 0 87 84 85 86 87 63 64 64 65 84 85 86 87 84 85 86 87 84 0 0 194 195 196 197 198 159 199 200 0 0 0 0 0 17 18 85 86 17 70 71 71 72 18 85 86 17 18 0 0 129 130 85 86 129 146 147 147 148 130 85 86 129 130 0 0 0 0 194 195 196 197 198 159 199 200 0 0 194 195 201 186 0 0 0 0 194 195 196 197 198 159 199 200 0 0 138 14 76 77 13 53 54 54 55 14 76 77 13 139 0 0 181 0 0 0 0 0 194 195 196 197 198 159 199 200 0 
 0 0 0 0 0 0 0 0 0 202 199 200 0 82 79 80 81 82 79 203 204 205 79 80 81 82 79 0 0 181 0 0 0 140 141 85 86 140 206 207 208 140 141 85 86 140 141 85 86 140 141 0 0 0 209 210 0 190 191 211 0 0 0 0 0 0 17 18 85 86 17 18 207 208 212 18 85 86 17 18 0 0 213 130 157 158 129 214 207 208 213 130 157 158 129 214 0 0 0 215 0 209 210 0 190 191 211 0 0 0 0 209 196 197 0 0 0 0 0 209 210 0 190 191 211 0 0 0 131 14 76 77 13 216 217 218 131 14 76 77 13 14 0 0 181 0 0 0 0 0 0 209 210 0 190 191 211 0 0 
 0 0 0 0 0 0 0 0 0 202 211 0 0 82 79 96 97 82 79 219 220 82 79 96 97 82 79 0 0 181 0 0 0 87 84 101 102 87 84 221 222 87 84 101 102 87 84 101 102 87 84 0 0 0 209 210 0 0 202 211 0 0 0 0 0 0 17 18 101 102 17 18 223 224 17 18 101 102 17 18 0 0 129 130 164 165 129 130 221 222 225 130 164 165 129 130 0 0 0 226 0 209 210 0 0 202 211 0 0 0 0 209 210 0 0 0 0 0 0 209 210 0 0 202 211 0 0 0 131 14 91 92 13 227 228 229 131 14 91 92 13 14 0 0 181 0 0 0 0 0 0 209 210 0 0 202 211 0 0 
 0 0 0 0 0 0 0 0 0 230 231 0 0 138 110 115 115 112 79 219 220 82 110 115 115 112 139 0 0 181 0 0 0 87 119 120 120 121 84 223 224 87 119 120 120 121 119 120 120 232 233 0 0 0 234 235 0 0 202 211 0 0 0 0 0 0 142 125 126 126 127 18 223 224 17 125 126 126 127 143 0 0 129 175 176 176 177 130 223 224 129 175 176 176 177 130 0 0 0 226 0 234 235 0 0 202 211 0 0 0 0 234 235 0 0 236 237 0 0 234 235 0 0 202 211 0 0 238 138 110 111 111 112 227 239 240 131 110 111 111 112 139 0 241 242 0 0 0 0 0 0 234 235 243 0 202 211 0 0 
 0 244 0 0 0 0 0 0 245 246 247 248 249 250 251 78 78 53 252 253 254 255 55 78 256 257 258 244 259 181 259 260 261 262 263 264 264 63 265 266 267 268 65 269 263 264 264 88 270 271 272 245 273 259 274 275 0 0 246 247 0 0 0 0 244 273 142 89 89 89 70 276 277 278 279 72 89 89 89 143 0 244 213 174 280 280 146 281 282 283 284 148 285 280 286 214 0 0 245 226 273 274 275 259 0 246 247 287 245 0 244 274 275 244 0 226 226 0 0 274 275 259 244 246 247 244 0 288 289 75 78 78 53 290 291 292 293 55 78 294 78 139 245 295 296 297 273 0 244 244 244 274 275 298 244 246 247 244 259 
 299 300 301 302 303 304 303 304 305 306 307 300 308 309 310 301 311 302 302 305 300 307 300 309 312 300 305 309 306 311 305 300 307 300 305 305 305 300 307 300 309 312 300 305 309 306 311 305 300 300 309 312 300 305 309 306 311 305 300 307 300 305 307 300 309 312 300 305 309 306 311 305 305 300 307 300 309 312 300 305 309 306 311 305 300 305 309 306 311 305 305 300 307 300 309 312 300 305 312 312 300 305 312 312 300 305 309 306 311 305 300 305 309 306 311 311 311 311 306 311 306 311 305 300 305 309 306 305 306 311 305 300 311 311 311 306 311 306 311 305 300 311 311 306 311 306 311 311 306 306 311 311 306 311 306 311 311 306 311 
 313 314 315 313 314 314 314 316 314 315 314 314 313 314 315 315 317 318 315 314 315 314 314 314 314 313 315 317 318 316 314 315 314 313 314 314 314 315 314 314 314 314 313 315 317 318 316 314 315 314 314 314 313 315 317 318 316 314 315 314 313 314 314 314 314 314 313 315 317 318 316 314 314 315 314 314 314 314 313 315 317 318 316 314 313 315 317 318 316 314 314 315 314 314 314 314 313 315 317 314 313 315 317 314 319 315 317 318 316 314 313 315 317 318 317 317 317 317 318 316 318 316 314 313 315 317 318 314 314 316 314 314 315 314 314 314 316 318 316 314 313 314 320 318 316 318 316 314 314 314 320 320 318 316 318 316 314 314 316 
 314 314 319 315 314 314 314 313 313 317 315 37 317 314 317 314 315 314 313 314 317 315 319 317 314 317 313 315 314 313 37 317 315 319 314 314 314 317 315 319 317 314 317 313 315 314 313 37 317 319 317 314 317 313 315 314 313 37 317 315 319 314 317 317 317 314 317 313 315 314 313 37 314 317 315 319 317 314 317 313 315 314 313 37 317 313 315 314 313 37 314 317 315 319 317 314 317 313 315 314 317 313 315 314 317 313 315 314 313 37 317 313 315 314 315 315 315 315 314 313 314 313 37 317 313 315 314 314 314 314 314 314 313 314 315 314 313 314 313 37 317 314 315 314 313 314 313 314 314 314 315 315 314 313 314 316 314 316 314 
 314 315 314 314 314 316 314 314 315 314 314 314 314 315 315 314 314 314 314 314 314 314 314 315 315 314 314 314 314 314 314 314 314 314 314 314 314 314 314 314 315 315 314 314 314 314 314 314 314 314 315 315 314 314 314 314 314 314 314 314 314 314 314 314 315 315 314 314 314 314 314 314 314 314 314 314 315 315 314 314 314 314 314 314 314 314 314 314 314 314 314 314 314 314 315 315 314 314 314 315 314 314 314 315 314 319 314 314 314 314 314 314 314 314 314 314 314 314 314 314 314 319 314 314 314 314 314 314 314 314 314 37 314 314 314 313 318 314 319 314 314 315 314 314 314 314 319 314 314 314 314 314 314 314 314 319 316 314 316 
